WWWWWWWWWWWWWW  WWWWWWWWWWWWWW
W                            W
W                            W
W        r                 c W
W                            W
WIIIIIIIIIIIIIIIIIIIII    IIIW
W                            W
W  c        s                W
W                            W
WIIIIIIIIII   IIIIIIIIIIIIIIIW
W                            W
W              r             W
W                         c  W
WIIIIIIIIIIIII    IIIIIIIIIIIW
W                            W
W                            W
W                            W
W                            W
W                            W
W             H              W
WWWWWWWWWWWWWW  WWWWWWWWWWWWWW