WWWWWWWWWWWWWW  WWWWWWWWWWWWWW
W  c                         W
W                            W
W                            W
W           r   r            W
W                            W
W        r                   W
W                            W
W                            W
W                            W
W                            W
W                            W
W  I    I          I   I     W
W  I    I          I   I     W
W  I    I          I   I     W
W  I    I          I   I     W
W  I    I          I   I     W
W  I    I          I   I     W
W  I    I          I   I     W
W  I    I          I   I     W
WWWWWWWWWWWWWW  WWWWWWWWWWWWWW