..............................
.                            .
.                            .
.                            .
.                            .
.                            .
.                            .
.                            .
.                      r     .
.                            .
.  r                         .
.                            .
.  I    I          Is  I     .
.  I    I          I   I   c .
.  I    I          I   I     .
.  I    I          I   I   c .
.  I    I          I   I     .
.  I    I          I   I   c .
.  I    I          I   I     .
.  I    I     H    I   I   c .
..............................