WWWWWWWWWWWWWWWWWWWWWWWWWWWWWW
W             c              W
W                            W
W                            W
W             T              W
W          t  O  t           W
W     r                r     W
W                            W
W          t     t           W
W                            W
W     s                r     W
W          t     t           W
W                            W
W             s              W
W          t     t           W
W    r                 s     W
W                            W
W                            W
W                            W
W             H              W
WWWWWWWWWWWWWW  WWWWWWWWWWWWWW