..............................
.                            .
.                            .
.         r                  .
.                            .
.IIIIIIIII IIIIIIIII IIIIIIII.
.                            .
.              s             .
.                            .
.IIIIIIIII IIIIIIIII IIIIIIII.
.                            .
.         r                  .
.                            .
.IIIIIIIII IIIIIIIII IIIIIIII.
.                            .
.                            .
.                            .
.         H                  .
.                            .
.                            .
..............................