..............................
.                            .
.                            .
.                            .
.                            .
.                            .
.                            .
.                            .
.                      r     .
.                            .
.  r                         .
.                            .
.                   s        .
.                            .
.  IIIIIIIIIIIIIIIIIIIIIIIIII.
.                            .
.                            .
.  IIIIIIIIIIIIIIIIIIIIIIIIII.
.                            .
.             H              .
..............................