..............................
.         s       s          .
.             T              .
.             O              .
.                            .
.          t     t           .
.                            .
.                            .
.          t     t           .
.                            .
.                            .
.          t     t           .
.                            .
.                            .
.          t     t           .
.                            .
.                            .
.                            .
.                            .
.                            .
..............................